111000001000000
001111111111010
000100000001110
001111100111010
011000101100010
010000000001010
010111101101010
010100111011110
011100010001000
010011110101110
010110000100010
010101110111010
010111011001000
000100001001001
01110100111111G
